{
    "_type": "stages",
    "_version": 1,
    "stages": [{
        "id": 1,
        "moves": 10,
        "score": 400,
        "spawn": [1, 2, 3, 4, 7],
        "tiles": [
            [0, 0, 2, 1, 1, 7, 0, 0],
            [0, 4, 7, 2, 4, 1, 3, 0],
            [2, 7, 4, 3, 7, 3, 7, 3],
            [1, 3, 2, 0, 0, 7, 2, 1],
            [3, 2, 1, 0, 0, 2, 7, 2],
            [7, 4, 2, 7, 1, 4, 3, 4],
            [0, 7, 4, 4, 2, 7, 4, 0],
            [0, 0, 2, 1, 1, 2, 0, 0]
        ]
    }, {
        "id": 2,
        "moves": 10,
        "score": 400,
        "spawn": [1, 5, 6, 7],
        "tiles": [
            [0, 0, 5, 6, 7, 1, 6, 1],
            [0, 6, 1, 5, 1, 5, 1, 5],
            [6, 7, 5, 6, 5, 6, 5, 0],
            [5, 7, 1, 6, 7, 1, 0, 0],
            [1, 5, 7, 1, 6, 7, 0, 0],
            [5, 6, 1, 6, 5, 1, 5, 0],
            [0, 5, 7, 5, 1, 7, 6, 1],
            [0, 0, 5, 1, 6, 5, 1, 5]
        ]
    }, {
        "id": 3,
        "moves": 10,
        "score": 400,
        "spawn": [1, 2, 4, 5, 7],
        "tiles": [
            [0, 4, 2, 0, 0, 1, 7, 0],
            [7, 2, 7, 2, 4, 7, 5, 2],
            [5, 1, 4, 1, 2, 4, 1, 4],
            [0, 0, 2, 7, 1, 5, 0, 0],
            [0, 0, 5, 1, 4, 2, 0, 0],
            [1, 2, 4, 2, 2, 4, 5, 4],
            [7, 5, 7, 5, 4, 7, 1, 5],
            [0, 4, 1, 0, 0, 2, 7, 0]
        ]
    }, {
        "id": 4,
        "moves": 10,
        "score": 500,
        "spawn": [1, 2, 3, 5, 6, 7],
        "tiles": [
            [0, 0, 0, 0, 5, 5, 3, 0],
            [0, 0, 0, 5, 6, 3, 6, 3],
            [3, 5, 5, 3, 7, 6, 2, 5],
            [7, 3, 6, 2, 1, 2, 5, 6],
            [1, 6, 3, 3, 1, 1, 5, 7],
            [2, 5, 5, 1, 7, 3, 1, 5],
            [0, 0, 0, 5, 3, 6, 3, 6],
            [0, 0, 0, 0, 5, 5, 6, 0]
        ]
    }, {
        "id": 5,
        "moves": 10,
        "score": 500,
        "spawn": [1, 2, 3, 4, 5, 6, 7],
        "tiles": [
            [0, 7, 4, 1, 5, 7, 0, 0],
            [3, 1, 5, 2, 3, 4, 0, 0],
            [2, 5, 3, 7, 1, 2, 5, 7],
            [6, 1, 0, 0, 6, 3, 6, 5],
            [1, 3, 0, 0, 5, 6, 1, 2],
            [5, 4, 2, 7, 1, 5, 3, 7],
            [3, 1, 5, 1, 4, 2, 0, 0],
            [0, 7, 2, 5, 5, 7, 0, 0]
        ]
    }, {
        "id": 6,
        "moves": 10,
        "score": 700,
        "spawn": [1, 3, 4, 7],
        "tiles": [
            [4, 1, 3, 7, 3, 4, 3, 7],
            [1, 4, 3, 4, 1, 3, 1, 4],
            [3, 7, 1, 3, 1, 7, 4, 3],
            [0, 0, 0, 0, 0, 0, 0, 0],
            [0, 0, 0, 0, 0, 0, 0, 0],
            [3, 7, 1, 4, 3, 7, 4, 3],
            [4, 1, 4, 3, 4, 3, 1, 4],
            [1, 3, 1, 7, 1, 1, 3, 7]
        ]
    }, {
        "id": 7,
        "moves": 10,
        "score": 500,
        "spawn": [3, 4, 5, 6, 7],
        "tiles": [
            [4, 0, 0, 0, 0, 0, 0, 5],
            [5, 4, 0, 0, 0, 0, 5, 6],
            [3, 5, 4, 0, 0, 5, 6, 3],
            [6, 3, 5, 4, 5, 6, 3, 5],
            [5, 6, 3, 5, 6, 3, 5, 4],
            [0, 5, 6, 3, 3, 5, 4, 0],
            [0, 0, 5, 6, 5, 4, 0, 0],
            [0, 0, 0, 5, 4, 0, 0, 0]
        ]
    }, {
        "id": 8,
        "moves": 10,
        "score": 600,
        "spawn": [1, 2, 3, 4, 5, 6, 7],
        "tiles": [
            [0, 6, 4, 1, 5, 2, 5, 6],
            [2, 5, 3, 2, 6, 5, 3, 1],
            [5, 2, 0, 0, 2, 1, 4, 5],
            [1, 6, 0, 0, 0, 0, 5, 2],
            [4, 2, 0, 0, 0, 0, 6, 1],
            [5, 1, 0, 0, 2, 3, 5, 4],
            [6, 3, 2, 1, 3, 6, 3, 2],
            [0, 1, 5, 6, 4, 5, 2, 6]
        ]
    }]
}